//MAP CONVERTED BY dmm2tgm.py THIS HEADER COMMENT PREVENTS RECONVERSION, DO NOT REMOVE
"a" = (
/turf/closed/wall/mineral/titanium/survival,
/area/shuttle/mining)
"b" = (
/obj/docking_port/mobile{
	dir = 8;
	dwidth = 3;
	height = 5;
	id = "mining";
	name = "mining shuttle";
	port_direction = 4;
	width = 7
	},
/obj/machinery/door/airlock/survival_pod/glass,
/obj/structure/fans/tiny,
/obj/effect/turf_decal/stripes/line{
	dir = 4
	},
/turf/open/floor/pod/dark,
/area/shuttle/mining)
"c" = (
/turf/open/floor/pod/light,
/area/shuttle/mining)
"h" = (
/obj/structure/table/reinforced,
/obj/structure/table/reinforced,
/obj/item/storage/toolbox/emergency,
/obj/effect/turf_decal/stripes/line{
	dir = 6
	},
/turf/open/floor/pod/dark,
/area/shuttle/mining)
"j" = (
/obj/structure/shuttle/engine/heater,
/obj/effect/spawner/structure/window/hollow/survival_pod/directional{
	dir = 8
	},
/obj/structure/window/reinforced,
/obj/structure/window/reinforced{
	dir = 4
	},
/turf/open/floor/plating/airless,
/area/shuttle/mining)
"m" = (
/obj/structure/chair/fancy/shuttle{
	dir = 4
	},
/obj/effect/turf_decal/stripes/line{
	dir = 1
	},
/turf/open/floor/pod/dark,
/area/shuttle/mining)
"s" = (
/obj/structure/chair/fancy/shuttle,
/obj/effect/turf_decal/stripes/line{
	dir = 1
	},
/turf/open/floor/pod/dark,
/area/shuttle/mining)
"z" = (
/obj/structure/chair/fancy/shuttle{
	dir = 4
	},
/turf/open/floor/pod/light,
/area/shuttle/mining)
"D" = (
/obj/machinery/computer/shuttle_flight/mining{
	dir = 8
	},
/obj/effect/turf_decal/stripes/line{
	dir = 4
	},
/turf/open/floor/pod/light,
/area/shuttle/mining)
"H" = (
/obj/effect/turf_decal/stripes/end{
	dir = 8
	},
/turf/open/floor/pod/light,
/area/shuttle/mining)
"L" = (
/obj/effect/turf_decal/stripes/corner{
	dir = 1
	},
/obj/effect/turf_decal/stripes/corner{
	dir = 8
	},
/turf/open/floor/pod/light,
/area/shuttle/mining)
"M" = (
/obj/structure/table/reinforced,
/obj/item/storage/firstaid/regular,
/obj/effect/turf_decal/stripes/line{
	dir = 5
	},
/turf/open/floor/pod/dark,
/area/shuttle/mining)
"Q" = (
/obj/effect/turf_decal/stripes/line{
	dir = 1
	},
/turf/open/floor/pod/dark,
/area/shuttle/mining)
"R" = (
/obj/structure/chair/fancy/shuttle{
	dir = 1
	},
/obj/effect/turf_decal/stripes/line,
/turf/open/floor/pod/dark,
/area/shuttle/mining)
"S" = (
/obj/item/clothing/suit/hazardvest{
	desc = "A high-visibility lifejacket complete with whistle and slot for oxygen tanks.";
	name = "emergency lifejacket"
	},
/obj/item/clothing/suit/hazardvest{
	desc = "A high-visibility lifejacket complete with whistle and slot for oxygen tanks.";
	name = "emergency lifejacket"
	},
/obj/item/clothing/suit/hazardvest{
	desc = "A high-visibility lifejacket complete with whistle and slot for oxygen tanks.";
	name = "emergency lifejacket"
	},
/obj/item/clothing/suit/hazardvest{
	desc = "A high-visibility lifejacket complete with whistle and slot for oxygen tanks.";
	name = "emergency lifejacket"
	},
/obj/item/clothing/suit/hazardvest{
	desc = "A high-visibility lifejacket complete with whistle and slot for oxygen tanks.";
	name = "emergency lifejacket"
	},
/obj/item/tank/internals/emergency_oxygen{
	pixel_x = 3
	},
/obj/item/tank/internals/emergency_oxygen{
	pixel_x = 3
	},
/obj/item/tank/internals/emergency_oxygen{
	pixel_x = 3
	},
/obj/item/tank/internals/emergency_oxygen{
	pixel_x = 3
	},
/obj/item/tank/internals/emergency_oxygen{
	pixel_x = 3
	},
/obj/item/clothing/mask/breath{
	pixel_x = -3;
	pixel_y = -3
	},
/obj/item/clothing/mask/breath{
	pixel_x = -3;
	pixel_y = -3
	},
/obj/item/clothing/mask/breath{
	pixel_x = -3;
	pixel_y = -3
	},
/obj/item/clothing/mask/breath{
	pixel_x = -3;
	pixel_y = -3
	},
/obj/item/clothing/mask/breath{
	pixel_x = -3;
	pixel_y = -3
	},
/obj/item/clothing/head/utility/hardhat/orange{
	name = "protective hat";
	pixel_y = 9
	},
/obj/item/clothing/head/utility/hardhat/orange{
	name = "protective hat";
	pixel_y = 9
	},
/obj/item/clothing/head/utility/hardhat/orange{
	name = "protective hat";
	pixel_y = 9
	},
/obj/item/clothing/head/utility/hardhat/orange{
	name = "protective hat";
	pixel_y = 9
	},
/obj/item/clothing/head/utility/hardhat/orange{
	name = "protective hat";
	pixel_y = 9
	},
/obj/structure/closet/crate/internals,
/obj/item/pickaxe/emergency,
/obj/item/pickaxe/emergency,
/obj/effect/turf_decal/delivery,
/obj/effect/turf_decal/stripes/line{
	dir = 9
	},
/turf/open/floor/pod/dark,
/area/shuttle/mining)
"V" = (
/obj/structure/shuttle/engine/heater,
/obj/effect/spawner/structure/window/hollow/survival_pod/directional{
	dir = 8
	},
/obj/structure/window/reinforced{
	dir = 4
	},
/obj/structure/window/reinforced{
	dir = 1
	},
/turf/open/floor/plating/airless,
/area/shuttle/mining)
"W" = (
/obj/structure/chair/fancy/shuttle{
	dir = 4
	},
/obj/effect/turf_decal/stripes/line,
/turf/open/floor/pod/dark,
/area/shuttle/mining)
"X" = (
/obj/structure/shuttle/engine/propulsion/left{
	dir = 8
	},
/turf/open/floor/plating/airless,
/area/shuttle/mining)
"Y" = (
/obj/effect/turf_decal/stripes/line,
/turf/open/floor/pod/dark,
/area/shuttle/mining)
"Z" = (
/obj/structure/ore_box,
/obj/effect/turf_decal/delivery,
/obj/effect/turf_decal/stripes/line{
	dir = 10
	},
/turf/open/floor/pod/dark,
/area/shuttle/mining)

(1,1,1) = {"
a
X
b
X
a
"}
(2,1,1) = {"
a
j
H
V
a
"}
(3,1,1) = {"
a
S
L
Z
a
"}
(4,1,1) = {"
a
s
c
R
a
"}
(5,1,1) = {"
a
s
c
R
a
"}
(6,1,1) = {"
a
Q
c
Y
a
"}
(7,1,1) = {"
a
m
z
W
a
"}
(8,1,1) = {"
a
M
D
h
a
"}
(9,1,1) = {"
a
a
a
a
a
"}
