//MAP CONVERTED BY dmm2tgm.py THIS HEADER COMMENT PREVENTS RECONVERSION, DO NOT REMOVE
"a" = (
/turf/open/floor/iron/dark/textured,
/area/template_noop)
"b" = (
/obj/structure/fence/mma{
	dir = 8
	},
/turf/open/floor/iron/white/smooth_large,
/area/template_noop)
"f" = (
/obj/structure/chair/fancy/sofa/corp{
	dir = 1
	},
/turf/open/floor/iron/white/side{
	dir = 1
	},
/area/template_noop)
"g" = (
/turf/open/floor/iron/white/smooth_large,
/area/template_noop)
"h" = (
/obj/structure/closet,
/obj/item/clothing/under/shorts/mma_shorts_blue,
/obj/item/clothing/under/shorts/mma_shorts_brazil,
/obj/item/clothing/under/shorts/mma_shorts_champion,
/obj/item/clothing/under/shorts/mma_shorts_green,
/obj/structure/window/reinforced{
	dir = 1
	},
/turf/open/floor/iron/dark/textured,
/area/template_noop)
"i" = (
/obj/structure/chair/fancy/sofa/corp/corner/concave{
	dir = 1
	},
/turf/open/floor/iron/white/corner{
	dir = 4
	},
/area/template_noop)
"k" = (
/obj/structure/window/reinforced{
	dir = 1
	},
/turf/open/floor/iron/dark/textured,
/area/template_noop)
"l" = (
/obj/structure/chair/fancy/sofa/corp{
	dir = 4
	},
/turf/open/floor/iron/white/side{
	dir = 4
	},
/area/template_noop)
"n" = (
/obj/structure/chair/fancy/sofa/corp{
	dir = 8
	},
/turf/open/floor/iron/white/side{
	dir = 8
	},
/area/template_noop)
"o" = (
/obj/structure/closet,
/obj/item/clothing/gloves/boxing/mmagloves_blue_championship,
/obj/item/clothing/gloves/boxing/mmagloves_red_championship,
/obj/item/clothing/gloves/boxing/mmagloves_blue,
/obj/item/clothing/gloves/boxing/mmagloves_red,
/obj/structure/window/reinforced{
	dir = 1
	},
/turf/open/floor/iron/dark/textured,
/area/template_noop)
"p" = (
/obj/structure/chair/fancy/sofa/corp/left{
	dir = 4
	},
/turf/open/floor/iron/white/corner,
/area/template_noop)
"q" = (
/obj/structure/chair/fancy/sofa/corp/left{
	dir = 1
	},
/turf/open/floor/iron/white/side{
	dir = 1
	},
/area/template_noop)
"s" = (
/obj/structure/fence/corner/mma{
	dir = 8
	},
/turf/open/floor/iron/white/smooth_large,
/area/template_noop)
"t" = (
/obj/structure/fence/door/mma,
/turf/open/floor/iron/white/smooth_large,
/area/template_noop)
"w" = (
/obj/structure/fence/corner/mma,
/turf/open/floor/iron/white/smooth_large,
/area/template_noop)
"D" = (
/obj/effect/turf_decal/tile/dark_blue/half,
/obj/item/storage/belt/mmachampion,
/turf/open/floor/iron/white/smooth_large,
/area/template_noop)
"E" = (
/obj/structure/chair/fancy/sofa/corp/right{
	dir = 1
	},
/turf/open/floor/iron/white/side{
	dir = 1
	},
/area/template_noop)
"G" = (
/obj/structure/fence/corner/mma{
	dir = 8
	},
/turf/open/floor/iron/white/side,
/area/template_noop)
"H" = (
/obj/effect/turf_decal/tile/dark_blue/anticorner_ramp{
	dir = 4
	},
/turf/open/floor/iron/white/smooth_large,
/area/template_noop)
"I" = (
/obj/effect/turf_decal/tile/dark_blue/anticorner_ramp{
	dir = 8
	},
/turf/open/floor/iron/white/smooth_large,
/area/template_noop)
"J" = (
/turf/open/floor/iron/white/side{
	dir = 1
	},
/area/template_noop)
"M" = (
/obj/structure/chair/fancy/sofa/corp/right{
	dir = 8
	},
/turf/open/floor/iron/white/corner{
	dir = 8
	},
/area/template_noop)
"N" = (
/obj/effect/turf_decal/tile/dark_blue/half{
	dir = 1
	},
/turf/open/floor/iron/white/smooth_large,
/area/template_noop)
"Q" = (
/obj/structure/chair/fancy/sofa/corp/corner/concave{
	dir = 8
	},
/turf/open/floor/iron/white/corner{
	dir = 1
	},
/area/template_noop)
"R" = (
/obj/effect/turf_decal/tile/dark_blue/half,
/turf/open/floor/iron/white/smooth_large,
/area/template_noop)
"T" = (
/obj/structure/fence/mma{
	dir = 8
	},
/turf/open/floor/iron/white/side,
/area/template_noop)
"W" = (
/obj/structure/fence/corner/mma{
	dir = 4
	},
/turf/open/floor/iron/white/side,
/area/template_noop)
"X" = (
/obj/structure/fence/mma,
/turf/open/floor/iron/white/smooth_large,
/area/template_noop)

(1,1,1) = {"
p
l
l
l
l
l
l
i
k
a
"}
(2,1,1) = {"
G
X
X
X
X
X
s
f
k
a
"}
(3,1,1) = {"
T
g
H
g
g
g
b
f
k
a
"}
(4,1,1) = {"
T
g
R
R
R
g
b
E
o
a
"}
(5,1,1) = {"
T
g
N
D
g
g
t
J
a
a
"}
(6,1,1) = {"
T
g
N
N
N
g
b
q
h
a
"}
(7,1,1) = {"
T
g
g
g
I
g
b
f
k
a
"}
(8,1,1) = {"
W
X
X
X
X
X
w
f
k
a
"}
(9,1,1) = {"
M
n
n
n
n
n
n
Q
k
a
"}
