//MAP CONVERTED BY dmm2tgm.py THIS HEADER COMMENT PREVENTS RECONVERSION, DO NOT REMOVE
"a" = (
/turf/open/floor/iron/techmaint,
/area/template_noop)
"b" = (
/obj/structure/fence/mma{
	dir = 8
	},
/turf/open/floor/iron/white/smooth_large,
/area/template_noop)
"d" = (
/obj/effect/turf_decal/stripes/white/corner{
	dir = 4
	},
/obj/effect/turf_decal/stripes/white/corner{
	dir = 1
	},
/turf/open/floor/iron/techmaint,
/area/template_noop)
"f" = (
/obj/structure/table/reinforced,
/obj/effect/turf_decal/tile/dark_blue/half/contrasted{
	dir = 8
	},
dir = 4},
/obj/item/storage/belt/mmachampion,
/turf/open/floor/iron/white/side{
	dir = 1
	},
/area/template_noop)
"g" = (
/turf/open/floor/iron/white/smooth_large,
/area/template_noop)
"i" = (
/obj/structure/chair/fancy/sofa/corp/right{
	dir = 4
	},
/turf/open/floor/iron/dark/textured,
/area/template_noop)
"k" = (
/obj/effect/turf_decal/stripes/white/line{
	dir = 1
	},
/turf/open/floor/iron/techmaint,
/area/template_noop)
"l" = (
/obj/structure/chair/fancy/sofa/corp{
	dir = 4
	},
/turf/open/floor/iron/dark/textured,
/area/template_noop)
"n" = (
/obj/structure/chair/fancy/sofa/corp{
	dir = 8
	},
/turf/open/floor/iron/dark/textured,
/area/template_noop)
"p" = (
/obj/structure/chair/fancy/sofa/corp/left{
	dir = 4
	},
/turf/open/floor/iron/dark/textured,
/area/template_noop)
"q" = (
/obj/effect/turf_decal/tile/dark_blue/half/contrasted{
	dir = 4
	},
/obj/effect/turf_decal/tile/dark_blue/half/contrasted{
	dir = 8
	},
/turf/open/floor/iron/white/side{
	dir = 1
	},
/area/template_noop)
"s" = (
/obj/structure/fence/corner/mma{
	dir = 8
	},
/obj/effect/turf_decal/tile/dark_blue/half/contrasted{
	dir = 1
	},
/turf/open/floor/iron/white/smooth_edge{
	dir = 4
	},
/area/template_noop)
"t" = (
/obj/structure/fence/door/mma,
/turf/open/floor/iron/white/smooth_large,
/area/template_noop)
"u" = (
/obj/effect/turf_decal/tile/dark_blue/half/contrasted{
	dir = 8
	},
/obj/effect/turf_decal/tile/dark_blue/half/contrasted{
	dir = 4
	},
/turf/open/floor/iron/white/side{
	dir = 1
	},
/area/template_noop)
"v" = (
/obj/structure/table/reinforced,
/obj/item/radio/intercom{
	pixel_y = 8
	},
/obj/effect/turf_decal/tile/dark_blue/half/contrasted{
	dir = 8
	},
/obj/effect/turf_decal/tile/dark_blue/half/contrasted{
	dir = 4
	},
/turf/open/floor/iron/white/side{
	dir = 1
	},
/area/template_noop)
"w" = (
/obj/structure/fence/corner/mma,
/obj/effect/turf_decal/tile/dark_blue/half/contrasted,
/turf/open/floor/iron/white/smooth_edge{
	dir = 8
	},
/area/template_noop)
"x" = (
/obj/structure/curtain/bounty,
/obj/structure/window/reinforced/tinted{
	dir = 8
	},
/turf/open/floor/iron/techmaint,
/area/template_noop)
"A" = (
/obj/structure/fence/mma{
	dir = 8
	},
/obj/effect/turf_decal/tile/dark_blue/half/contrasted{
	dir = 8
	},
/obj/effect/turf_decal/tile/dark_blue/half/contrasted{
	dir = 4
	},
/turf/open/floor/iron/white/side,
/area/template_noop)
"B" = (
/obj/structure/fence/mma,
/obj/effect/turf_decal/tile/dark_blue/half/contrasted,
/turf/open/floor/iron/white/smooth_edge{
	dir = 8
	},
/area/template_noop)
"E" = (
/obj/structure/table/reinforced,
/obj/structure/desk_bell,
/obj/effect/turf_decal/tile/dark_blue/half/contrasted{
	dir = 8
	},
/obj/effect/turf_decal/tile/dark_blue/half/contrasted{
	dir = 4
	},
/turf/open/floor/iron/white/side{
	dir = 1
	},
/area/template_noop)
"F" = (
/obj/structure/closet{
	name = "Red Corner closet"
	},
/obj/item/clothing/under/shorts/mma_shorts_blue,
/obj/item/clothing/under/shorts/mma_shorts_brazil,
/obj/item/clothing/under/shorts/mma_shorts_champion,
/obj/item/clothing/under/shorts/mma_shorts_green,
/obj/item/clothing/gloves/boxing/mmagloves_red_championship,
/obj/item/clothing/gloves/boxing/mmagloves_red,
/obj/structure/window/reinforced/tinted{
	dir = 8
	},
/obj/structure/window/reinforced/tinted{
	dir = 1
	},
/turf/open/floor/iron/techmaint,
/area/template_noop)
"G" = (
/obj/structure/fence/corner/mma{
	dir = 8
	},
/obj/effect/turf_decal/tile/dark_blue/half/contrasted{
	dir = 8
	},
/obj/effect/turf_decal/tile/dark_blue/half/contrasted{
	dir = 4
	},
/turf/open/floor/iron/white/side,
/area/template_noop)
"H" = (
/obj/effect/turf_decal/tile/dark_blue/anticorner_ramp{
	dir = 4
	},
/turf/open/floor/iron/white/smooth_large,
/area/template_noop)
"I" = (
/obj/effect/turf_decal/tile/dark_blue/anticorner_ramp{
	dir = 8
	},
/turf/open/floor/iron/white/smooth_large,
/area/template_noop)
"J" = (
/obj/effect/turf_decal/stripes/white/line{
	dir = 8
	},
/obj/effect/turf_decal/stripes/white/line{
	dir = 4
	},
/turf/open/floor/iron/techmaint,
/area/template_noop)
"K" = (
/obj/effect/turf_decal/stripes{
	dir = 1
	},
/obj/effect/turf_decal/stripes/white/line{
	dir = 1
	},
/turf/open/floor/iron/techmaint,
/area/template_noop)
"M" = (
/obj/structure/chair/fancy/sofa/corp/right{
	dir = 8
	},
/turf/open/floor/iron/dark/textured,
/area/template_noop)
"N" = (
/obj/effect/turf_decal/tile/dark_blue/half{
	dir = 1
	},
/turf/open/floor/iron/white/smooth_large,
/area/template_noop)
"O" = (
/obj/structure/closet{
	name = "Blue Corner closet"
	},
/obj/item/clothing/under/shorts/mma_shorts_blue,
/obj/item/clothing/under/shorts/mma_shorts_brazil,
/obj/item/clothing/under/shorts/mma_shorts_champion,
/obj/item/clothing/under/shorts/mma_shorts_green,
/obj/item/clothing/gloves/boxing/mmagloves_blue_championship,
/obj/item/clothing/gloves/boxing/mmagloves_blue,
/obj/structure/window/reinforced/tinted{
	dir = 4
	},
/obj/structure/window/reinforced/tinted{
	dir = 1
	},
/turf/open/floor/iron/techmaint,
/area/template_noop)
"Q" = (
/obj/structure/chair/fancy/sofa/corp/left{
	dir = 8
	},
/turf/open/floor/iron/dark/textured,
/area/template_noop)
"R" = (
/obj/effect/turf_decal/tile/dark_blue/half,
/turf/open/floor/iron/white/smooth_large,
/area/template_noop)
"T" = (
/obj/effect/turf_decal/tile/dark_blue/half/contrasted{
	dir = 8
	},
/obj/structure/fence/mma{
	dir = 8
	},
/obj/effect/turf_decal/tile/dark_blue/half/contrasted{
	dir = 4
	},
/turf/open/floor/iron/white/side,
/area/template_noop)
"V" = (
/obj/structure/window/reinforced/tinted{
	dir = 4
	},
/obj/structure/curtain/bounty,
/obj/structure/window/reinforced/tinted{
	dir = 4
	},
/turf/open/floor/iron/techmaint,
/area/template_noop)
"W" = (
/obj/structure/fence/corner/mma{
	dir = 4
	},
/obj/effect/turf_decal/tile/dark_blue/half/contrasted{
	dir = 8
	},
/obj/effect/turf_decal/tile/dark_blue/half/contrasted{
	dir = 4
	},
/turf/open/floor/iron/white/side,
/area/template_noop)
"X" = (
/obj/structure/fence/mma,
/obj/effect/turf_decal/tile/dark_blue/half/contrasted{
	dir = 1
	},
/turf/open/floor/iron/white/smooth_edge{
	dir = 4
	},
/area/template_noop)
"Y" = (
/obj/structure/chair/office{
	dir = 1
	},
/obj/effect/turf_decal/stripes/white/line{
	dir = 1
	},
/turf/open/floor/iron/techmaint,
/area/template_noop)

(1,1,1) = {"
p
l
l
l
l
l
l
i
k
a
"}
(2,1,1) = {"
G
X
X
X
X
X
s
f
Y
a
"}
(3,1,1) = {"
T
g
H
g
g
g
b
v
Y
a
"}
(4,1,1) = {"
A
g
R
R
R
g
b
E
Y
a
"}
(5,1,1) = {"
A
g
N
R
g
g
t
J
d
a
"}
(6,1,1) = {"
A
g
N
N
N
g
b
q
k
F
"}
(7,1,1) = {"
A
g
g
g
I
g
b
u
K
V
"}
(8,1,1) = {"
W
B
B
B
B
B
w
q
K
x
"}
(9,1,1) = {"
M
n
n
n
n
n
n
Q
k
O
"}
